1111111111111
1P0E1M0M100M1
11M1101010101
1001101010101
110110101C101
1101101011001
110110101M101
1101C01000101
1C01101010101
1101101010101
11000011C0001
1111111111111